Academia Cultural de Curitiba | ACCUR
Agência Especial de Financiamento Industrial | Finame
Agência Nacional de Aviação Civil | Anac
Agência Nacional de Telecomunicações | ANATEL
Agência Nacional de Águas | ANA
Agência Promotora de Exportações | Apex
Agência de Desenvolvimento do Ceará | Adece
Aliança Nacional Libertadora | ANL
Aliança Renovadora Nacional | Arena
Aquisição e Administação de Patrimônios | AAP
Associação Atlética Banco do Brasil | AABB
Associação Baiana de Criadores | Abac
Associação Beneficente Cearense de Reabilitação | ABCR
Associação Brasileira Interdisciplinar da Aids | ABIA
Associação Brasileira da Indústria Farmacêutica | ABIF
Associação Brasileira da Indústria Têxtil e de Confecções | ABIT
Associação Brasileira da Indústria de Café | ABIC
Associação Brasileira de Bancos de Desenvolvimento | ABDE
Associação Brasileira de Educação | ABE
Associação Brasileira de Empresas de Televisão | Abrate
Associação Brasileira de Imprensa | ABI
Associação Brasileira de Normas Técnicas | ABNT
Associação Brasileira de Produtores de Milho | Abramilho
Associação Brasileira de Recursos Hídricos | ABRH
Associação Brasileira de Reforma Agrária | ABRA
Associação Brasileira dos Municípios | ABM
Associação Catarinense de Supermercados | Acats
Associação Comercial da Barra da Tijuca | Acibarra
Associação Comercial de São Paulo | ACSP
Associação Comercial do Rio de Janeiro | ACRJ
Associação Nacional das Universidades Particulares | ANUP
Associação Nacional de Bancos de Investimentos | Anbid
Associação Paulista de Citricultura | Associtrus
Associação Paulista de Magistrados | APM
Associação Promotora de Estudos de Economia | Apec
Associação das Emissoras de São Paulo | AESP
Associação das Magistrados Mineiros | Amagis
Associação de Crédito e Assistência Rural | ACAR 
Associação de Crédito e Assistência Rural de Mato Grosso | Acarmat
Associação de Crédito e Assistência Rural do Estado de Santa Catarina | ACARESC
Associação do Comércio Exterior do Brasil | AEB
Associação dos Diplomados da Escola Superior de Guerra | ADESG
Associação dos Estudantes Secundaristas da Bahia | AESB
Associação dos Juízes Federais do Brasil | AJUFE
Associação dos Licenciados em Santa Catarina | Alisc
Associação dos Magistrados Brasileiros | AMB
Associação dos Municípios Alagoanos | AMA
Associação dos Municípios da Alta Noroeste | AMAN
Associação dos Municípios do Extremo Noroeste | AMENSP
Associação dos Países Produtores de Café | APPC
Associação dos Produtores de Côco | Prococo
Ação Democrática Parlamentar | ADP
Banco Interamericano de Desenvolvimento | BID
Banco Nacional da Habitação | BNH
Banco Nacional de Crédito Cooperativo| BNCC
Banco Nacional de Desenvolvimento Econômico | BNDE
Banco Nacional de Habitação | BNH
Banco Nacional do Desenvolvimento Econômico Social | BNDES
Banco Société Génerale | Sogeral
Banco União Comercial | BUC
Banco de Desenvolvimento de Minas Gerais | BDMG
Banco de Desenvolvimento de São Paulo | Badesp
Banco de Desenvolvimento do Paraná | Badep
Banco do Estado da Bahia | Baneb
Banco do Estado de Goiás | BEG
Banco do Estado de Mato Grosso | Bemat
Banco do Estado de Minas Gerais | Bemge
Banco do Nordeste do Brasil | BNB
Bolsa de Valores de São Paulo | Bovespa
Caixa Econômica Federal | CEF
Caixa de Previdência | Previcaixa 
Campanha Nacional de Educandários da Comunidade | CNEC
Campanha Nacional de Escolas Comunidade | CNEC
Campanha Nacional de Escolas da Comunidade | CNEC
Associação Brasileira de Indústrias Gráficas | Abigraf
Centrais Elétricas Brasileiras | Eletrobrás
Centrais Elétricas Sul do Brasil | Eletrosul
Centrais Elétricas de Goiás | Celg
Centrais Elétricas de Santa Catarina | Celesc
Centrais Elétricas de São Paulo | CESP
Centrais Elétricas de Urubupungá S.A. | Celusa
Centrais Elétricas do Maranhão | Cemar
Centrais Elétricas do Norte do Brasil | Eletronorte
Centrais Elétricas do Rio das Contas | CERC
Centrais Elétricas do Sul do Brasil | Eletrosul
Central Autônoma dos Trabalhadores | CAT 
Central de Abastecimento de Santa Catarina | Ceasa
Central de Medicamentos | CEME
Central Única dos Trabalhadores | CUT
Centro Acadêmico Cândido de Oliveira | CACO
Centro Brasil Democrático | Cebrade
Centro Brasileiro de Análise e Planejamento | Cebrap
Centro Brasileiro de Apoio à Pequena e Média Empresa | Cebrae
Centro Brasileiro de Apoio às Micro e Pequenas Empresas | Cebrae 
Centro Brasileiro de Estudos Latino-Americanos | Cebela
Centro Brasileiro de Estudos da Saúde | CEBES
Centro Ibero-Americano de Desenvolvimento Estratégico Urbano | CIDEU
Centro Industrial do Brasil | CIB
Centro Industrial do Rio de Janeiro | CIRJ
Centro Sportivo Alagoano | CSA
Centro das Indústrias de São Paulo | CIESP
Centro das Indústrias do Rio Grande do Sul | CIERGS
Centro de Ensino Unificado de Brasília | CEUB
Centro de Estudos de Cultura Contemporânea | Cedec
Centro de Estudos e Debates do Gurguéia | Cedeg
Centro de Integração Empresa-Escola | Ciee
Centro de Pesquisa e Documentação de História Contemporânea do Brasil | Cpdoc
Centro de Preparação de Oficiais da Reserva | CPOR
Clube de Regatas Brasil | CRB
Colégio Adventista Brasileiro | CAB
Colégio Estadual Rio Branco | Cerb
Colégio Moderno faculdades Integradas | FICOM
Comando Geral dos Trabalhadores | CGT
Comissão Nacional de Erradicação do Trabalho Infantil | Conaeti
Comitê Olímpico Brasileiro | COB
Comitê para o Desenvolvimento Integral da Primeira Infância | Codipi
Companhia Agrícola de Mato Grosso | Camat
Companhia de Águas, Esgoto e Saneamento | CAES
Companhia Auxiliar de Empresas de Mineração | Caemi
Companhia Brasileira de Participação | Cobrapar
Companhia Brasileira de Trens Urbanos | CBTU 
Companhia Brasileira de Alimentos | Cobal
Companhia Brasileira de Investimentos | CBI
Companhia Catarinense de Água e Esgoto | CASAN
Companhia Catarinense de Águas e Saneamento | Casan
Companhia Energética de São Paulo | CESP
Companhia Estadual de Energia Elétrica | CEEE
Companhia Estadual de Habitação | Cehab
Companhia Estadual de Águas | Cedag
Companhia Geral de Laminação | Cogeral
Companhia Habitacional | Cohab
Companhia Habitacional do Maranhão | Cohab/MA
Companhia Hidrelétrica de Boa Esperança | Cohebe
Companhia Hidro Elétrica do São Francisco | CHESF
Companhia Industrial de Produtos Alimentícios | CIPA
Companhia Industrial do Ceará | CDI
Companhia Metropolitana de Habitação de São Paulo | Cohab-SP
Companhia Mineradora de Minas Gerais | Comig
Companhia Municipal de Transportes Coletivos | CMTC
Companhia Nacional de Abastecimento | CONAB
Companhia Paranaense de Energia | Copel
Companhia Paulista de Força e Luz | CPFL
Companhia Pernambucana de Borracha Sintética | Coperbo
Companhia Progresso do Estado da Guanabara | Copeg
Companhia Prudentina de Desenvolvimento | Prudenco
Companhia Química de Laminados | Formiplac
Companhia Real Holandesa de Aviação | KLM
Companhia Regional de Abastecimento Integrado de Santo André | CRAISA
Companhia Rio-grandense de Saneamento | Corsan
Companhia Siderúrgica Nacional | CSN
Companhia Siderúrgica Paulista | Cosipa
Companhia Siderúrgica de Tubarão | CST
Companhia Urbanizadora da Nova Capital | Novacap
Companhia Urbanizadora da Serra do Curral | Ciurbe
Companhia Vale do Rio Doce | CVRD
Companhia das Docas do Estado da Bahia | Codeba
Companhia das Docas do Estado do Espírito | Codesa
Companhia de Armazenamento Geral do Estado de Pernambuco | CAGEP
Companhia de Armazéns Gerais do Estado de São Paulo | CAGESP
Companhia de Armazéns e Silos | Casemat
Companhia de Comércio e Participação | Copar
Companhia de Desenvolvimento Agrícola de São Paulo | CODASP
Companhia de Desenvolvimento Agrícola do Estado de São Paulo | CODASP
Companhia de Desenvolvimento da Região Metropolitana | Conder
Companhia de Desenvolvimento de Londrina | Codel
Companhia de Desenvolvimento de Mogi das Cruzes | Codema
Companhia de Desenvolvimento de Roraima | CODESAIMA
Companhia de Desenvolvimento de Vitória | CDV
Companhia de Desenvolvimento do Paraná | Codepar
Companhia de Desenvolvimento do Vale do São Francisco | Codevasf
Companhia de Eletricidade da Bahia | Coelba
Companhia de Eletricidade da Bahia | Cotelba
Companhia de Eletricidade de Borborema | Celb
Companhia de Eletricidade de Pernambuco | Celpe
Companhia de Eletricidade do Acre | Eletroacre
Companhia de Eletricidade do Amapá | CEA
Companhia de Eletricidade do Estado do Rio de Janeiro | CERJ
Companhia de Entrepostos e Armazéns Gerais do Estado de São Paulo | CEAGESP
Companhia de Geração Térmica de Energia Elétrica | CGTEE
Companhia de Habitação | Cohab
Companhia de Habitação Popular | Cohab 
Companhia de Habitação Popular do Estado da Guanabara | Cohab
Companhia de Habitação do Ceará | COHAB-CE
Companhia de Habitação do Paraná | Cohapar 
Companhia de Mineração de Rondônia | CMR
Companhia de Pescas Oceânicas do Maranhão | Oceomar
Companhia de Promoção Agrícola | Campo
Companhia de Saneamento Básico do Estado de São Paulo | Sabesp
Companhia de Saneamento de Mato Grosso | Sanemat
Companhia de Saneamento de Minas Gerais | Copasa
Companhia de Telecomunicações de São Paulo | Telesp
Companhia de Telecomunicações do Paraná | Telepar 
Companhia do Desenvolvimento Industrial | Codin
Comunidade dos Países de Língua Portuguesa | CPLP
Confederação Brasileira de Desportos | CBD
Confederação Brasileira de Futebol | CBF
Confederação Geral dos Trabalhadores | CGT
Confederação Nacional da Indústria | CNI
Confederação Nacional das Indústrias | CNI
Confederação Nacional de Agricultura | CNA
Confederação Nacional do Comércio | CNC
Confederação Nacional dos Bispos do Brasil | CNBB
Confederação Nacional dos Municípios | CNM
Confederação Nacional dos Trabalhadores em Educação | CNTE
Confederação Nacional dos Trabalhadores em Empresas de Crédito | Contec
Confederação Nacional dos Trabalhadores em Estabelecimentos de Crédito | Contec
Confederação Nacional dos Trabalhadores em Saúde | CNTS
Confederação Nacional dos Trabalhadores em Transportes Marítimos, Fluviais e Aéreos | CNTTMFA
Confederação Nacional dos Trabalhadores em Transportes Terrestres | CNTTT
Confederação Nacional dos Trabalhadores em Turismo e Hospitalidade | CONTRATUH
Confederação Nacional dos Trabalhadores na Agricultura | Contag
Confederação Nacional dos Trabalhadores na Indústria | CNTI
Confederação da Agricultura e Pecuária do Brasil | CNA
Confederação das Associações Comerciais do Brasil | CACB
Confederação de Professores do Brasil | CPB
Conselho Americano do Esporte | CADE
Conselho Consultivo Internacional | International Advisor Board
Conselho Consultivo da Associação Cultural do Arquivo Nacional | ACAN
Conselho Estadual do Meio Ambiente | COEMA
Conselho Estadual do Meio Ambiente | Cemam
Conselho Nacional de Desportos | CND
Conselho Nacional de Pesquisa | CNPq
Conselho Nacional de Petróleo | CNP
Conselho Nacional de Secretários de Saúde | Conass
Conselho Nacional de Segurança Pública | Conasp
Conselho Nacional de Telecomunicações | Contel 
Conselho Nacional de Transito | CONTRAN
Conselho Nacional do Café | CNC  
Conselho Nacional do Petróleo | CNP
Conselho Nacional dos Secretários de Saúde | Conass
Conselho Regional de Engenharia e Arquitetura | CREA
Conselho Regional de Medicina | CRM
Conselho de Desenvolvimento Econômico e Social da Presidência da República | CDES
Conselho de Política Aduaneira | CPA
Cooperativa Habitacional | Cohab 
Cooperativa dos Plantadores de Cana | Coplana 
Coordenação do Desenvolvimento de Brasília | Codebrás
Câmara Brasileira da Indústria da Construção | CBIC
Câmara dos Dirigentes Lojistas | CDL
Democratas | DEM
Departamento Estadual de Telecomunicações | Detel
Departamento Nacional do Café | DNC
Diretório Central de Estudantes | DCE
Diretório Central dos Estudantes | DCE 
Empresa Brasileira de Correios e Telegráfos | ECT
Empresa Brasileira de Radiodifusão | Radiobrás
Empresa Brasileira de Telecomunicações | Embratel
Empresa Brasileira de Transportes Urbanos | EBTU
Empresa Brasileira de Turismo | Embratur
Empresa Distribuidora de Energia em Sergipe | Energipe
Empresa Municipal de Urbanismo | Emurb
Empresa Paraibana de Turismo | Paraibatur
Empresa Teresinense de Desenvolvimento Urbano | Eturb
Empresa de Desenvolvimento Urbano e Habitacional | EMUHR
Federação Acreana de Desportos | FAD
Federação Agrícola do Estado de São Paulo 
Federação Alagoana de Desporto Universitário | Fadu
Federação Brasileira dos Bancos | Febraban
Federação Latino-Americana de Magistrados | FLAM
Federação Nacional dos Jornalistas Profissionais | Fenag
Federação Nacional dos Trabalhadores Gráficos | FNTG
Federação Tocantinense de Futebol | FTF
Federação Universitária Mineira dos Estudantes | FUME
Federação das Indústrias do Ceará | FIEC
Federação das Indústrias do Distrito Federal | FIDF
Federação das Indústrias do Estado da Bahia | FIEB
Federação das Indústrias do Estado de Goiás | Fieg
Federação das Indústrias do Estado de Minas Gerais | FIEMG
Federação das Indústrias do Estado de Pernambuco | FIEP
Federação das Indústrias do Estado de Santa Catarina | FIESC
Federação das Indústrias do Estado do Amazonas | Fieam
Federação das Indústrias do Estado do Paraná | FIEP
Federação das Indústrias do Estado do Pará | Fiepa
Federação das Indústrias do Rio Grande do Norte
Federação das Indústrias do Rio de Janeiro | Firjan
Financiadora de Estudos e Projetos | Finep
Football International Federations Association | FIFA
Fórum Nacional de Representantes dos Estados | Fonare
Frente Nacional de Prefeitos | FNP
Frente Nacional dos Prefeitos | FNP
Frente Parlamentar Nacionalista | FPN
Frente Parlamentar contra a Prostituição Infantil
Frente Parlamentar da Agropecuária | FPA 
Frente Parlamentar de Cooperativismo | Frencoop
Fundação Alexandre Gusmão | Funag
Fundação Biblioteca Nacional | FBN
Fundação Centro Tecnológico de Minas Gerais | Cetec
Fundação Educacional Edson Queirós | Unifor
Fundação Educacional de Gurupi | FEG
Fundação Estadual de Educação do Menor | FEEM
Fundação Gaúcha de Lazer e Recreação | Funlar
Fundação Municipal de Trabalho | FUNDAT 
Fundação Nacional da Saúde | Funasa
Fundação Nacional de Arte | Funarte 
Fundação Nacional do Índio | Funai 
Fundação Rede Ferroviária de Seguridade Social | Refer
Fundação Social de Curitiba | FAS 
Fundação Ulysses Guimarães | FUG
Fundação Universidade Estadual de Campinas | Funcamp
Fundação de Assistência ao Estudante | FAE
Fundação do Ensino Primário | Fundeprim
Fórum Interparlamentar das Américas | FIPA
Fórum Nacional de Secretários de Trabalho | Fonset
Grêmio Recreativo Escola de Samba | Gres 
Indústria Brasileira de Coque | Ibracoque
Indústria Nacional de Pescados | Inpesca
Instituto Brasileiro de Atuária | IBA
Instituto Brasileiro de Bibliografia e Documentação | IBBD
Instituto Brasileiro de Desenvolvimento Florestal | IBDF
Instituto Brasileiro de Economia | Ibre 
Instituto Brasileiro de Geografia e Estatística | IBGE
Instituto Brasileiro de Mercado de Capitais | Ibmec
Instituto Brasileiro de Reforma Agrária | IBRA
Instituto Brasileiro de Siderurgia | IBS
Instituto Brasileiro de Ética Concorrencial | ETCO
Instituto Brasileiro do Café | IBC
Instituto Brasileiro do Petróleo
Instituto Brasiliense de Direito Público | IDP
Instituto Histórico e Geográfico Brasileiro | IHGB
Instituto Nacional Colonização e Reforma Agrária | INCRA
Instituto Nacional da Previdência Social | INPS
Instituto Nacional da Previdência Social | INPS 
Instituto Nacional de Imigração e Colonização | INIC
Instituto Nacional de Previdência Social | INPS
Instituto Nacional de Propriedade Industrial | INPI 
Instituto Nacional de Reforma Agrária | INCRA
Instituto Tancredo Neves | ITN
Instituto da Previdência dos Congressistas | IPC
Instituto de Arquitetos do Brasil | IAB 
Instituto de Desenvolvimento Comunitário | Indec
Instituto de Engenharia do Paraná | IEP
Instituto de Pesquisas Econômicas Aplicadas | IPEA
Instituto de Planejamento Urbano de Joinville | Ipuj
Instituto de Previdência de Mato Grosso | Ipmat
Instituto de Previdência do Estado | IPE
Instituto de Previdência dos Congressistas | IPC
Instituto de Resseguros do Brasil | IRB
Instituto de Seleção e Orientação Profissional | ISOP
Instituto de Terras de Mato Grosso | Intermat
Instituto do Açúcar e do Álcool | IAA
Instituto dos Advogados Brasileiros | IAB
Instituto dos Arquitetos da Bahia | IAB
International Political Science Association | IPSA
International Sociological Association | ISA
Juventude Universitária Católica | JUC
Legião Brasileira de Assistência | LBA
Legião da Mulher Paraense | Lempa 
Liga de Defesa Nacional | LDN
Lions Clube de Inhumas | GO
Lions Clube de Paraíba do Sul | RJ
Listas Telefônicas Brasileiras
Loteria Estadual do Maranhão | Lotema
Loteria Estadual do Rio de Janeiro | Loterj
Loteria do Estado do Rio | Loterj
Loteria do Estado do Rio de Janeiro 
Loteria do Rio de Janeiro | Loterj
Movimento Democrático Brasileiro | MDB 
Movimento Feminino pela Anistia | MFA
Movimento Nacional de Luta pela Moradia | MNLM
Movimento Unificador dos Trabalhadores | MUT
Museu de Arte Moderna | MAM
Novacap | Companhia Urbanizadora da Nova Capital
Nucleares Brasileiras | Nuclebrás
Operador Nacional do Sistema Elétrico | ONS
Organização das Cooperativas Brasileiras | OCB
Organização das Cooperativas do Paraná | Ocepar
Organização das Voluntárias de Goiás | OVG
Organização dos Estados Americanos | OEA
Parlamento Latino-Americano | Parlatino 
Partido Comunista Italiano | PCI
Partido Democrata Cristão | PDC
Partido Democrático Trabalhista | PDT
Partido Geral dos Trabalhadores | PGT
Partido Liberal (PL
Partido Libertador | PL
Partido Municipalista Brasileiro | PMB
Partido Nacional Socialista do Piauí
Partido Popular | PP
Partido Popular Socialista | PPS 
Partido Progressista Mineiro | PP
Partido Progressita | PP
Partido Republicano Liberal | PRL
Partido Republicano Mineiro | PRM
Partido Republicano Rio-Grandense | PRR
Partido Social Democrático | PSD 
Partido Social Progressista | PSP
Partido Social Trabalhista | PST
Partido Trabalhista Brasileiro | PTB
Partido Trabalhista Brasileiro | PTB-RJ
Partido da Frente Liberal | PFL 
Partido da Social Democracia Brasileira | PSDB
Partido do Movimento Democrático Brasileiro | PMDB
Partido dos Democratas | DEM
Partido dos Trabalhadores | PT
Programa Estadual de Desestatização | PED
Saneamento do Rio de Janeiro | Sanerj
Serviço Social do Comércio | Sesc
Serviço Nacional de Aprendizagem Comercial Departamento Nacional | Senac 
Sindicato Nacional daAeroviárias | SNEA
Sindicato da Indústria Têxtil do Estado de São Paulo | Sinditextil/SP
Sindicato da Indústria de Construção Civil | SINDUSCON
Sindicato do Comércio Varejista de Marília | SCVM
Sindicato dos Fabricantes de Autopeças | Sindipeças
Sistema Federação das Indústrias do Paraná | Fiep
Sociedade Brasileira de Economistas Rurais | Sober
Sociedade Brasileira de Instrução | SBI
Sociedade Evangélica Beneficente de Curitiba | Seb
Sociedade Habitacional de Interesse Social | SHIS
Sociedade Mineira de Engenheiros | SME
Sociedade Nacional de Agricultura | SNA
Sociedade Paulista de Instalações Gerais | SPIG
Sociedade Rural Brasileira | SRB
Sociedade Termoelétrica de Capivari | Solteca
Superintendência da Política Agrária | Supra
Supremo Tribunal Federal | STF
Supremo Tribunal de Justiça | STJ
Telecomuicações de Santa Catarina | TELESC
Telecomunicações da Paraíba | Telpa
Telecomunicações de Campina Grande | Telingra
Telecomunicações de Santa Catarina | Telesc
Telecomunicações do Rio de Janeiro | Telerj
Tribunal Regional Eleitoral | TRE 
Tribunal Regional Federal | TRF 
Tribunal Regional de Trabalho | TRT 
Tribunal Superior Eleitoral | TSE
Tribunal de Segurança Nacional | TSN
União Brasileira de Avicultura | UBA
União Brasileira de Estudantes Secundaristas | UBES
União Brasileira de Estudantes Secundários | UBES
União Campograndense dos Estudantes | UCE
União Caxiense de Estudantes | UCE
União Democrática Nacional | UDN
União Democrática Ruralista | UDR
União Estadual de Estudantes | UEE 
União Feminina do Brasil | UFB
União Geral dos Trabalhadores | UGT
União Internacional dos Arquitetos | UIA
União Maranhense dos Estudantes Secundaristas | UMES
União Metropolitana de Estudantes | UME
União Nacional Estudantil | UNE
União Nacional dos Legislativos Estaduais | Unale
União Parlamentar Interestadual | UPI
União Republicana Maranhense | URM
União da Juventude Socialista | UJS
União das Associações Agropecuárias do Brasil Central
União das Cidades Capitais Ibero-Americanas | UCCI
União de Negócios e Administração | UNA
União dos Estudantes da Bahia | UEB
União dos Prefeitos da Bahia | UPB
Universidade de São Paulo | USP
Universidade Estadual de Campinas | UNICAMP
Universidade Federal do Rio Grande do Sul | UFRGS
Universidade Federal do Rio de Janeiro | UFRJ
Universidade Estadual Paulista Júlio de Mesquita Filho | UNESP
Universidade Federal de Minas Gerais | UFMG
Universidade Federal de Santa Catarina | UFSC
Universidade Federal do Paraná | UFPR
Universidade de Brasília | UNB
Universidade Federal Fluminense | UFF
Universidade Federal da Bahia | UFBA
Universidade Federal de São Paulo | UNIFESP
Universidade Federal do Ceará | UFC
Universidade do Estado do Rio de Janeiro | UERJ
Universidade Federal de Pernambuco | UFPE
Pontificia Universidade Católica do Rio de Janeiro | PUC-RIO
Universidade Federal do Rio Grande do Norte | UFRN
Universidade Federal do Pará | UFPA
Universidade Federal de Goiás | UFG
Universidade Federal de São Carlos | UFSCAR
Pontificia Universidade Católica do Rio Grande do Sul | PUCRS
Universidade Federal de Santa Maria | UFSM
Universidade Estadual de Maringá | UEM
Universidade Federal da Paraíba | UFPB
Universidade Estadual de Londrina | UEL
Universidade Federal de Viçosa | UFV
Universidade Federal de Uberlândia | UFU
Universidade Federal do Amazonas | UFAM
Fundação Getulio Vargas | FGV
Universidade Estadual de Montes Claros | UNIMONTES
Pontificia Universidade Católica do Paraná | PUCPR
Universidade Federal de Juiz de Fora | UFJF
Universidade Federal do ABC | UFABC
Universidade Federal do Espírito Santo | UFES
Universidade Federal de Lavras | UFLA
Universidade Federal de Pelotas | UFPEL
Universidade Federal de Campina Grande | UFCG
Universidade Federal Rural de Pernambuco | UFRPE
Universidade do Vale do Rio dos Sinos | UNISINOS
Universidade Federal de Mato Grosso do Sul | UFMS
Universidade Federal de Ouro Preto | UFOP
Universidade Tecnológica Federal do Paraná | UTFRP
Universidade do Estado de Santa Catarina | UDESC
Universidade Federal do Rio Grande | FURG
Universidade de Santa Cruz do Sul | UNISC
Pontificia Universidade Católica do Minas Gerais | PUC-MINAS
Universidade Federal de Mato Grosso | UFMT
Universidade Federal de São João del Rei | UFSJ
Universidade Federal de Sergipe | UFS
Universidade Federal do Maranhão | UFMA
Universidade Estadual de Ponta Grossa | UEPG
Pontificia Universidade Católica de São Paulo | PUC-SP
Universidade Federal do Piauí | UFPI
Universidade Estadual do Oeste do Paraná | UNIOSTE
Universidade Católica de Brasilia | UCB
Universidade de Passo Fundo | UPF
Universidade Federal Rural do Rio de Janeiro | UFRRJ
Universidade Estadual de Feira de Santana | UEFS
Universidade Nove de Julho | UNINOVE
Universidade de Caxias do Sul | UCS
Universidade Estadual da Paraíba | UEPB
Universidade Estadual do Ceará | UECE
Instituto Tecnológico de Aeronáutica | ITA
Universidade Luterana do Brasil |UL BRA
Universidade do Estado da Bahia | UNEB
Universidade do Vale do Itajaí | UNIVALI
Faculdade de Medicina de São José do Rio Preto | FAMERP
Faculdade de Ciências Médicas da Santa Casa de São Paulo | FCMSCSP
Pontificia Universidade Católica do Campinas | PUC-CAMPINAS
Universidade Federal Rural da Amazônia | UFRA
Universidade Federal do Estado do Rio de Janeiro | UNIRIO
Universidade Federal de Itajubá | UNIFEI
Universidade Federal de Alagoas | UFAL
Universidade do Sul de Santa Catarina | UNISUL
Universidade de Fortaleza | UNIFOR
Universidade Estadual do Sudoeste da Bahia | UESB
Universidade Regional de Blumenau | FURB
Universidade Estadual de Santa Cruz | UESC
Universidade de Pernambuco | UPE
Universidade do Extremo Sul Catarinense | UNESC
Universidade Federal do Pampa | UNIPAMPA
Universidade Federal dos Vales do Jequitinhonha e Mucuri | UFVJM
Universidade Estadual do Norte Fluminense Darcy Ribeiro | UENF
Centro Federal de Educacão Tecnológica de Minas Gerais | CEFET-MG
Universidade Estadual de Goiás | UEG 
Universidade Federal do Recôncavo da Bahia | UFRB
Universidade Estadual do Centro Oeste | UNICENTRO
Universidade do Estado de Mato Grosso | UNEMAT
Universidade Federal de Alfenas | UNIFAL-MG
Universidade Veiga de Almeida | UVA
Universidade Federal de Rondônia | UNIR
Universidade Federal da Grande Dourados | UFGD
Universidade Paulista | UNIP
Universidade Federal do Tocantins | UFT
Universidade Federal do Vale do São Francisco | UNIVASF
Universidade Federal do Acre | UFAC
Usina Siderúrgica de Minas Gerais | Usiminas
Vale do Rio Doce Navegação | Docenave
Viação Aérea São Paulo | VASP
